..........#..........................
.........###.........................
........#####........................
.......#######.......................
......#########.............#........
.....###########...........###.......
....#############.........#####......
...###############.......#######.....
..#################.....#########....
.###################.#.###########...
##########S########################..
.###########################S#######.
..###################S#############..
...###################SB##########...
....#############################....
.....###########################.....
......#########################......
.......#########S#######S#####.......
........#######################......
.......#########################.....
......####B######################....
.....###S#############.###########...
......#############################..
.......#############################.
.......#############S#######S########
......B#############################.
.....############SB################..
....##################S##########B...
...#######S######################....
....############################.....
.....#############S######S######.....
......#########################......
.......#######..#############B.......
........#####....###..#######........
.........###......#....#####.........
..........#.............###..........
.........................#...........
